Directory	datasets
50Words	TRAIN	50words/50words_TRAIN	50words/50words_TEST
Adiac	TRAIN	Adiac/Adiac_TRAIN	Adiac/Adiac_TEST
Beef	TRAIN	Beef/Beef_TRAIN		Beef/Beef_TEST
CBF	TRAIN	CBF/CBF_TRAIN	CBF/CBF_TEST
Coffee	TRAIN	Coffee/Coffee_TRAIN	Coffee/Coffee_TEST
Chlorine	TRAIN	Chlorine/Chlorine_TRAIN	Chlorine/Chlorine_TEST
CinECG	TRAIN	CinECG/CinECG_TRAIN	CinECG/CinECG_TEST
CricketX	TRAIN	Cricket_X/Cricket_X_TRAIN	Cricket_X/Cricket_X_TEST
CricketY	TRAIN	Cricket_Y/Cricket_Y_TRAIN	Cricket_Y/Cricket_Y_TEST
CricketZ	TRAIN	Cricket_Z/Cricket_Z_TRAIN	Cricket_Z/Cricket_Z_TEST
DiatomSize	TRAIN	DiatomSize/DiatomSize_TRAIN	DiatomSize/DiatomSize_TEST
ECG200		TRAIN	ECG200/ECG200_TRAIN	ECG200/ECG200_TEST
ECGFiveDays	TRAIN	ECGFiveDays/ECGFiveDays_TRAIN	ECGFiveDays/ECGFiveDays_TEST
ElectricDevices	TRAIN	ElectricDevices/ElectricDevices_TRAIN	ElectricDevices/ElectricDevices_TEST
FaceAll	TRAIN	FaceAll/FaceAll_TRAIN	FaceAll/FaceAll_TEST
FaceFour	TRAIN	FaceFour/FaceFour_TRAIN	FaceFour/FaceFour_TEST
FacesUCR	TRAIN	FacesUCR/FacesUCR_TRAIN	FacesUCR/FacesUCR_TEST
Fish	TRAIN	Fish/Fish_TRAIN	Fish/Fish_TEST
Gun_Point	TRAIN	Gun_Point/Gun_Point_TRAIN	Gun_Point/Gun_Point_TEST
Haptics	TRAIN	Haptics/Haptics_TRAIN	Haptics/Haptics_TEST
InlineSkate	TRAIN	InlineSkate/InlineSkate_TRAIN	InlineSkate/InlineSkate_TEST
ItalyPower	TRAIN	ItalyPower/ItalyPower_TRAIN	ItalyPower/ItalyPower_TEST
Lighting2	TRAIN	Lighting2/Lighting2_TRAIN	Lighting2/Lighting2_TEST
Lighting7	TRAIN	Lighting7/Lighting7_TRAIN	Lighting7/Lighting7_TEST
MALLAT	TRAIN	MALLAT/MALLAT_TRAIN	MALLAT/MALLAT_TEST
MedicalImages	TRAIN	MedicalImages/MedicalImages_TRAIN	MedicalImages/MedicalImages_TEST
MoteStrain	TRAIN	MoteStrain/MoteStrain_TRAIN	MoteStrain/MoteStrain_TEST
NonInv_ECG1	TRAIN	NonInv_ECG1/NonInv_ECG1_TRAIN	NonInv_ECG1/NonInv_ECG1_TEST
NonInv_ECG2	TRAIN	NonInv_ECG2/NonInv_ECG2_TRAIN	NonInv_ECG2/NonInv_ECG2_TEST
OliveOil	TRAIN	OliveOil/OliveOil_TRAIN	OliveOil/OliveOil_TEST
OSULeaf	TRAIN	OSULeaf/OSULeaf_TRAIN	OSULeaf/OSULeaf_TEST
SonyAIBO1	TRAIN	SonyAIBO1/SonyAIBO1_TRAIN	SonyAIBO1/SonyAIBO1_TEST
SonyAIBO2	TRAIN	SonyAIBO2/SonyAIBO2_TRAIN	SonyAIBO2/SonyAIBO2_TEST
StarLight	TRAIN	StarLight/StarLight_TRAIN	StarLight/StarLight_TEST
SwedishLeaf	TRAIN	SwedishLeaf/SwedishLeaf_TRAIN	SwedishLeaf/SwedishLeaf_TEST
Symbols	TRAIN	Symbols/Symbols_TRAIN	Symbols/Symbols_TEST
Synthetic	TRAIN	Synthetic/Synthetic_TRAIN	Synthetic/Synthetic_TEST
Trace	TRAIN	Trace/Trace_TRAIN	Trace/Trace_TEST
Two_Patterns	TRAIN	Two_Patterns/Two_Patterns_TRAIN	Two_Patterns/Two_Patterns_TEST
TwoLeadECG	TRAIN	TwoLeadECG/TwoLeadECG_TRAIN	TwoLeadECG/TwoLeadECG_TEST
uWGestureX	TRAIN	uWGestureX/uWGestureX_TRAIN	uWGestureX/uWGestureX_TEST
uWGestureY	TRAIN	uWGestureY/uWGestureY_TRAIN	uWGestureY/uWGestureY_TEST
uWGestureZ	TRAIN	uWGestureZ/uWGestureZ_TRAIN	uWGestureZ/uWGestureZ_TEST
Wafer	TRAIN	Wafer/Wafer_TRAIN	Wafer/Wafer_TEST
WordsSynonyms	TRAIN	WordsSynonyms/WordsSynonyms_TRAIN	WordsSynonyms/WordsSynonyms_TEST
Yoga	TRAIN	Yoga/Yoga_TRAIN	Yoga/Yoga_TEST
